DSNY Storm # ,Date of Report ,Manhattan,Bronx,Brooklyn,Queens,Staten Island ,Total Tons 
Storm 1,01/19/2016 12:00:00 AM,1111,2059,2690,6625,2931,15416
Storm 2,01/23/2016 12:00:00 AM,2919,4567,5521,9253,4264,26524
Storm 2,01/24/2016 12:00:00 AM,6582,8167,12290,17133,5411,49583
Storm 2,01/25/2016 12:00:00 AM,3862,4094,6217,10236,1256,25665
Storm 2,01/26/2016 12:00:00 AM,2499,3299,5120,7685,764,19367
Storm 2,01/27/2016 12:00:00 AM,2609,2007,4619,5656,1830,16721
Storm 2,01/28/2016 12:00:00 AM,1878,2017,2889,4090,560,11434
Storm 2,01/29/2016 12:00:00 AM,906,1652,2647,2829,338,8372
Storm 2,01/30/2016 12:00:00 AM,569,1134,1101,1675,75,4554
Storm 2,01/31/2016 12:00:00 AM,379,598,426,1140,80,2623
Storm 2,02/01/2016 12:00:00 AM,202,453,120,792,0,1567
Storm 2,02/02/2016 12:00:00 AM,66,302,276,448,0,1092
Storm 2,02/03/2016 12:00:00 AM,34,288,144,452,0,918
Storm 2,02/04/2016 12:00:00 AM,0,73,0,277,0,350
Storm 2,02/05/2016 12:00:00 AM,1495,1631,4641,7885,2054,17706
Storm 2,02/06/2016 12:00:00 AM,127,596,1822,2597,440,5582
Storm 2,02/08/2016 12:00:00 AM,26,28,0,303,40,397
Storm 3,02/09/2016 12:00:00 AM,614,1447,3433,6340,1288,13122
Storm 3,02/10/2016 12:00:00 AM,300,664,404,1496,235,3099
Storm 3,02/11/2016 12:00:00 AM,79,630,188,1944,440,3281
Storm 3,02/12/2016 12:00:00 AM,44,130,118,261,245,798
Storm 3,02/14/2016 12:00:00 AM,30,5,130,139,50,354
Storm 4,02/16/2016 12:00:00 AM,2367,4690,6645,5747,4445,23894
Storm 4,02/17/2016 12:00:00 AM,62,652,0,4,0,718
Storm 5,03/07/2016 12:00:00 AM,1305,1670,4448,4465,1240,13128
Storm 1,12/19/2016 12:00:00 AM,4992,6780,9597,13750,2635,37754
Storm 2,01/07/2017 12:00:00 AM,2665,3440,6553,7096,3040,22794
Storm 3,01/08/2017 12:00:00 AM,3173,7976,10707,12948,3953,38757
Storm 3,01/09/2017 12:00:00 AM,4189,2760,3543,6336,1230,18058
Storm 3,01/10/2017 12:00:00 AM,1181,767,767,1715,270,4700
Storm 3,01/13/2017 12:00:00 AM,27,287,0,610,0,924
Storm 4,02/01/2017 12:00:00 AM,1619,3242,4207,5266,1824,16158
Storm 5,02/10/2017 12:00:00 AM,7091,6515,13013,13187,7231,47037
Storm 5,02/11/2017 12:00:00 AM,2393,2900,5818,5018,2450,18579
Storm 5,02/12/2017 12:00:00 AM,1141,2400,1912,2994,1883,10330
Storm 5,02/13/2017 12:00:00 AM,1056,2400,3075,3740,2432,12703
Storm 5,02/14/2017 12:00:00 AM,39,6,414,341,116,916
Storm 5,02/15/2017 12:00:00 AM,16,204,492,100,0,812
Storm 5,02/17/2017 12:00:00 AM,4,351,609,925,0,1889
Storm 6,03/11/2017 12:00:00 AM,1782,2560,4216,5061,2549,16168
Storm 6,03/13/2017 12:00:00 AM,0,4,2,82,0,88
Storm 7,03/15/2017 12:00:00 AM,6700,7458,14810,17736,6857,53561
Storm 7,03/16/2017 12:00:00 AM,2275,3947,7435,6566,2580,22803
Storm 7,03/17/2017 12:00:00 AM,1624,3003,2456,3406,2450,12939
Storm 7,03/18/2017 12:00:00 AM,1255,2145,888,2486,263,7037
Storm 7,03/19/2017 12:00:00 AM,1015,2642,1770,1978,277,7682
Storm 7,03/20/2017 12:00:00 AM,810,993,1149,1405,300,4657
Storm 7,03/21/2017 12:00:00 AM,326,582,903,392,0,2203
Storm 7,03/22/2017 12:00:00 AM,448,572,572,296,0,1888
Storm 7,03/23/2017 12:00:00 AM,205,278,357,404,300,1544
Storm 7,03/24/2017 12:00:00 AM,54,197,324,115,0,690
Storm 7,03/25/2017 12:00:00 AM,0,195,125,0,200,520
Storm 1,12/10/2017 12:00:00 AM,3704,6884,11569,12920,4913,39990
Storm 1,12/11/2018 12:00:00 AM,442,398,2924,650,1103,5517
Storm 2,12/15/2017 12:00:00 AM,2414,4558,4469,7946,3900,23287
Storm 2,12/16/2017 12:00:00 AM,3789,5939,4864,10954,3988,29534
Storm 2,12/18/2017 12:00:00 AM,0,168,32,0,78,278
Storm 3,01/02/2018 12:00:00 AM,1818,6518,7119,15888,5204,36547
Storm 4,01/05/2018 12:00:00 AM,6399,8310,14988,14616,4536,48849
Storm 4,01/06/2018 12:00:00 AM,3570,6094,6304,5604,1220,22792
Storm 4,01/07/2018 12:00:00 AM,2268,4071,5133,4391,1375,17238
Storm 4,01/08/2018 12:00:00 AM,1069,1317,3041,1984,478,7889
Storm 4,01/09/2018 12:00:00 AM,745,2625,3953,3098,1180,11601
Storm 4,01/10/2018 12:00:00 AM,249,485,272,325,180,1511
Storm 4,01/11/2018 12:00:00 AM,29,392,207,32,0,660
Storm 4,01/12/2018 12:00:00 AM,5,165,120,50,170,510
Storm 4,01/13/2018 12:00:00 AM,0,4,32,4,0,40
Storm 4,01/16/2018 12:00:00 AM,0,45,146,53,64,308
Storm 5,01/18/2018 12:00:00 AM,1864,3558,4251,8861,4042,22576
Storm 5,01/19/2018 12:00:00 AM,14,3,5,4,30,56
Storm 6,01/31/2018 12:00:00 AM,1357,2192,4170,6418,1538,15675
Storm 7,02/08/2018 12:00:00 AM,1575,2996,3714,3533,2212,14030
Storm 8,02/20/2018 12:00:00 AM,2311,4321,4944,6148,2382,20106
Storm 9,03/08/2018 12:00:00 AM,6148,8212,10255,12774,4700,42089
Storm 9,03/09/2018 12:00:00 AM,182,342,938,1497,602,3561
Storm 9,03/10/2018 12:00:00 AM,0,126,32,0,124,282
Storm 10,03/14/2018 12:00:00 AM,1796,3236,4707,7662,2313,19714
Storm 11,03/22/2018 12:00:00 AM,6612,9432,10831,13411,4000,44286
Storm 11,03/23/2018 12:00:00 AM,738,1297,2370,1898,3500,9803
Storm 11,03/26/2018 12:00:00 AM,44,1,0,137,0,182
Storm 12,04/04/2018 12:00:00 AM,1250,3218,3082,5133,983,13666
Storm 1,11/16/2018 12:00:00 AM,2883,4650,7728,10710,3110,29081
Storm 1,11/17/2018 12:00:00 AM,406,486,2119,1886,1000,5897
Condition 2,11/26/2018 12:00:00 AM,936,1220,1564,2461,460,6641
Condition 3,12/14/2018 12:00:00 AM,1282,2992,3345,7103,2169,16891
Condition 4,12/21/2018 12:00:00 AM,0,363,194,318,144,1019
Storm 2,01/14/2019 12:00:00 AM,1569,2117,1962,4692,2800,13140
Storm 3,01/18/2019 12:00:00 AM,2192,3449,6226,5925,4739,22531
Storm 3,01/19/2019 12:00:00 AM,111,715,1014,0,120,1960
Storm 3,01/20/2019 12:00:00 AM,2008,3885,3413,7273,2679,19258
Storm 3,01/22/2019 12:00:00 AM,134,2723,1614,7382,620,12473
Storm 4,01/30/2019 12:00:00 AM,1994,2482,2992,4268,2312,14048
Storm 4,01/31/2019 12:00:00 AM,966,2384,4266,2330,2054,12000
Storm 4,02/01/2019 12:00:00 AM,42,202,202,15,0,461
Storm 5,02/13/2019 12:00:00 AM,4350,8349,15702,15196,5648,49245
Storm 5,02/14/2019 12:00:00 AM,100,426,650,844,275,2295
Storm 6,02/18/2019 12:00:00 AM,1642,3273,2596,6061,524,14096
Storm 6,02/21/2019 12:00:00 AM,4063,6659,9996,9783,4106,34607
Storm 6,02/22/2019 12:00:00 AM,154,142,232,142,0,670
Storm 7,02/28/2019 12:00:00 AM,1613,3700,3804,4310,1778,15205
Storm 7,03/01/2019 12:00:00 AM,2266,4161,2272,4440,840,13979
Storm 7,03/03/2019 12:00:00 AM,3794,8000,8182,5968,3883,29827
Storm 8,03/04/2019 12:00:00 AM,2743,5559,5277,8223,2696,24498
Storm 8,03/05/2019 12:00:00 AM,507,2157,2015,3349,122,8150
Storm 8,03/06/2019 12:00:00 AM,46,192,0,226,226,690
Storm 8,03/08/2019 12:00:00 AM,44,8,0,69,100,221
Storm 1,12/01/2019 12:00:00 AM,2805,6588,9345,14452,2414,35604
Storm 1,12/02/2019 12:00:00 AM,3358,6446,9643,17235,2966,39648
Storm 1,12/03/2019 12:00:00 AM,522,1145,943,4320,150,7080
Storm 1,12/04/2019 12:00:00 AM,2,0,0,25,0,27
Condition 2,12/11/2019 12:00:00 AM,2576,5080,6546,10094,2132,26428
Condition 3,12/16/2019 12:00:00 AM,2126,5123,7487,10775,2175,27686
Condition 3,12/17/2019 12:00:00 AM,253,623,0,0,68,944
Storm 2,12/18/2019 12:00:00 AM,271,3351,5864,6200,1550,17236
Storm 2,12/19/2019 12:00:00 AM,1195,1540,0,1325,105,4165
Condition 5,01/06/2020 12:00:00 AM,777,1110,1394,3198,750,7229
Storm 3,01/18/2020 12:00:00 AM,4935,6392,9141,13637,3350,37455
Condition 1,12/10/2020 12:00:00 AM,9,64,204,598,110,985
Storm 1,12/17/2020 12:00:00 AM,6070,7061,12076,13880,6893,45980
Storm 1,12/18/2020 12:00:00 AM,3753,6983,10222,17884,3954,42796
Storm 1,12/19/2020 12:00:00 AM,1388,3637,4488,11919,916,22348
Storm 1,12/20/2020 12:00:00 AM,1314,2696,1976,6401,550,12937
Storm 1,12/21/2020 12:00:00 AM,474,1385,1242,2623,220,5944
Storm 1,12/22/2020 12:00:00 AM,243,1095,1552,2398,69,5357
Storm 1,12/23/2020 12:00:00 AM,41,685,884,2879,0,4489
Storm 1,12/23/2020 12:00:00 AM,0,42,202,645,0,889
Condition 5,01/20/2021 12:00:00 AM,16,234,542,960,62,1814
Condition 6,01/27/2021 12:00:00 AM,2060,5852,3557,10563,1155,23187
Condition 6,01/29/2021 12:00:00 AM,25,0,112,1225,325,1687
Storm 2,02/01/2021 12:00:00 AM,4170,5341,7964,9635,3222,30332
Storm 2,02/02/2021 12:00:00 AM,4916,7914,10118,13440,2090,38478
Storm 2,02/03/2021 12:00:00 AM,2430,3407,5680,5772,1855,19144
Storm 2,02/04/2021 12:00:00 AM,1295,2101,2505,4434,1052,11387
Storm 2,02/05/2021 12:00:00 AM,954,1355,1479,4153,520,8461
Storm 2,02/06/2021 12:00:00 AM,550,1461,1278,4227,180,7696
Storm 2,02/07/2021 12:00:00 AM,272,591,508,1051,102,2524
Storm 3,02/08/2021 12:00:00 AM,3330,4936,6590,13169,1668,29693
Storm 3,02/09/2021 12:00:00 AM,293,619,1076,3710,545,6243
Storm 3,02/10/2021 12:00:00 AM,15,276,606,1477,680,3054
Storm 4,02/11/2021 12:00:00 AM,1458,3187,3364,5433,1316,14758
Storm 4,02/12/2021 12:00:00 AM,806,1003,1685,2669,1358,7521
Storm 4,02/13/2021 12:00:00 AM,0,2,0,102,1761,1865
Storm 4,02/14/2021 12:00:00 AM,2399,4009,3343,8647,4997,23395
Storm 4,02/15/2021 12:00:00 AM,46,80,276,635,580,1617
Storm 4,02/16/2021 12:00:00 AM,0,0,231,866,374,1471
Storm 4,02/17/2021 12:00:00 AM,6,280,1116,560,69,2031
Storm 5,02/18/2021 12:00:00 AM,921,1220,2660,4292,311,9404
Storm 5,02/19/2021 12:00:00 AM,4170,6853,7364,12829,4111,35327
Storm 5,02/20/2021 12:00:00 AM,3130,4581,4273,6605,2346,20935
Storm 5,02/21/2021 12:00:00 AM,141,618,393,1261,1086,3499
Storm 5,02/22/2021 12:00:00 AM,0,24,80,100,12,216
Storm 6,02/23/2021 12:00:00 AM,145,942,614,1098,364,3163
Storm 6,02/24/2021 12:00:00 AM,64,140,328,391,31,954
Storm 6,02/25/2021 12:00:00 AM,0,58,378,382,0,818
Storm 6,02/26/2021 12:00:00 AM,0,65,84,223,0,372
Condition 13,03/19/2021 12:00:00 AM,0,289,55,648,0,992
Condition 1,11/28/2021 12:00:00 AM,152,553,767,710,300,2482
Condition 2,12/12/2021 12:00:00 AM,547,730,946,450,651,3324
Condition 3,12/28/2021 12:00:00 AM,0,12,330,264,550,1156
Condition 4,01/05/2022 12:00:00 AM,662,923,743,1364,1250,4942
Storm 1,01/07/2022 12:00:00 AM,4502,3199,6878,11433,2301,28313
Storm 1,01/08/2022 12:00:00 AM,2378,2800,5927,7511,2670,21286
Storm 1,01/09/2022 12:00:00 AM,1266,1439,4090,3064,2863,12722
Storm 1,01/10/2022 12:00:00 AM,117,557,1715,957,610,3956
Storm 1,01/11/2022 12:00:00 AM,0,476,1165,143,591,2375
Storm 1,01/12/2022 12:00:00 AM,0,26,0,48,11,85
Storm 2,01/17/2022 12:00:00 AM,3186,3013,5612,10152,2571,24534
Condition 8,01/20/2022 12:00:00 AM,2632,2765,6560,6544,2141,20642
Condition 9,01/24/2022 12:00:00 AM,1936,2705,2954,6185,755,14535
Storm 3,01/29/2022 12:00:00 AM,3150,4103,8863,9483,3443,29042
Storm 3,01/30/2022 12:00:00 AM,3974,6870,6783,5946,2895,26468
Storm 3,01/31/2022 12:00:00 AM,2310,4108,4011,4345,842,15616
Storm 3,02/01/2022 12:00:00 AM,241,521,1535,826,232,3355
Storm 3,02/02/2022 12:00:00 AM,138,615,678,269,1028,2728
Storm 3,02/03/2022 12:00:00 AM,18,582,248,280,325,1453
Storm 3,02/04/2022 12:00:00 AM,0,1586,1321,2050,322,5279
Storm 3,02/05/2022 12:00:00 AM,3321,4383,3335,3336,1230,15605
Storm 3,02/06/2022 12:00:00 AM,0,162,192,1500,162,2016
Storm 3,02/07/2022 12:00:00 AM,1160,1404,845,3165,137,6711
Storm 3,02/08/2022 12:00:00 AM,0,1541,1217,4510,550,7818
Storm 4,02/14/2022 12:00:00 AM,3660,4946,5361,6941,1709,22617
Condition 14,02/19/2022 12:00:00 AM,622,874,686,2311,130,4623
Condition 15,02/24/2022 12:00:00 AM,3186,3586,3841,5019,1516,17148
Condition 15,02/25/2022 12:00:00 AM,1930,1925,1519,469,0,5843
Condition 16,03/09/2022 12:00:00 AM,2358,2416,2133,5892,1917,14716
Storm 5,03/12/2022 12:00:00 AM,2460,3695,3455,4830,2060,16500
